1111111111111111111
1P0100C101000010001
1101101001101000111
1C010M0010000101001
1011011010101101011
1001001010000100001
1100010C00010101011
1001000110000101001
101001000011000C101
100M00010000010M001
1101101001101000111
1001000010C00101001
1011011010101101011
1001000M00C00100001
11M0010001010101011
1C010001000001010E1
1111111111111111111