1111111111111111111
1P0100C1010000100C1
1101101001101000111
10010M0010C00101001
1011011010101101011
1001001010000100001
1100010000010101011
10010001100001C1001
1010010000110000101
100M00010000010M001
1101101001101000111
1001000010C00101001
1011011010101101011
1001000M00000100001
11M0010001010101011
10010001000001C10E1
1111111111111111111