1111111111
1P001000E1
1000100001
1000100001
1C00100001
1000100001
1000000001
1000100001
1111111111