1111111111
1P00100001
1000100001
110010C001
1C00100001
1000E00001
1000100001
1000110001
1000100001
1111111111