1111111111111111111
1P0100C1010000100C1
1101101001101000111
1001000010C00101001
1011011010101101011
1001001010000100001
1100010001010101011
10010001000001C10E1
1111111111111111111
