1111111111111111111
1P0100C1010000100C1
1101101001101000111
1001000010C00101001
1011011010101101011
1001001010000100001
1100010000010101011
10010001100001C1001
1010010000110000101
1000000100000100001
1101101001101000111
1001000010C00101001
1011011010101101011
1001000000000100001
1100010001010101011
10010001000001C10E1
1111111111111111111