1111111111111111111
1P0100C1010M0010001
1101101001101000111
1C010M0010C00101001
1011011010101101011
1001001010M00100001
1100010C00010101011
1C01000110000101001
101001000011000C101
100M00010000010M001
1101101001101000111
1M0100C010C00101001
1011011010101101011
1001000M00M00100M01
11M0010001010101011
1C01000100C001010E1
1111111111111111111