1111111111111111111
1P01000101000010001
1101101001101000111
1C010M0010000101001
1011011010101101011
1001001010M00100001
1100010000010101011
1C01000110000101001
1010010000110000101
1000000100000100001
1101101001101000111
100100C010000101001
1011011010101101011
1001000000M00100001
1100010001010101011
1C010001000001010E1
1111111111111111111