11111111111111111111111111111111111
11P01000001000001001001001000000011
110010010010010000010010010010C0011
11000001000000001001001001001000011
11001001001001001001000001001000011
11001C01001000001C00001000001000E11
11111111111111111111111111111111111