11111111111111111111111111111111
1P1111111111111C1111111111111111
10111111111111111111111111111111
1011111000011111111C111111111111
10011111111111111111111111111111
100000000010000000C00000000000E1
11111111111111111111111111111111