111111111111111111111111111111111
1P01000001C00001001001C0100000001
10010010010010000010010010010C001
100100100000000100100100100100001
100000100100100100100000100100001
1001C01001000001C00001000001000E1
111111111111111111111111111111111